####################
#..................#
#....M.........f...#
#....###...M.......#
#..............w...#
#..W...P...........#
#......###G#.......#
#.................F#
#....l.....P.......#
#..................#
#..e..........G..E.#
####################
